11111111111111111111111111111111
100000000000000000000000000000P1
10000000000000000000000000000001
10000000000000000000000000000001
10000000000000000000000000000001
10000000000000000000000000000001
10000000000000000000000000000001
10000000000000000000000000000001
10000000000000000000000000000001
10000000000000000000000000000001
100000000C0000000000000000000001
100000000000C0000000000000000001
10000000000000C00000000000000001
11111111111111111111111111111111